000000000000000000000000000000000000000000000000000000000000
000000000000000000000000000000000000000000000000000000000000
000000000000000000000000000000000000000000000000000000000000
000000000000000000000000000000000000000000000000000000000000
000000000000000000000000000000000000000000000000000000000000
000000000000000000000000000000000000000000000000000000000000
0##########################################################0
0#00000000000000000000000000000000000000000000000000000000#0
0#00000000000000000000000000000000000000000000000000000000#0
0#00000000000000000000000000000000000000000000000000000000#0
0#00000000000000000000000000000000000000000000000000000000#0
0#00000000000000000000000000000000000000000000000000000000#0
0#00000000000000000000000000000000000000000000000000000000#0
0#00000000000000000000000000000000000000000000000000000000#0
0#00000000000000000000000000000000000000000000000000000000#0
0#00000000000000000000000000000000000000000000000000000000#0
0#00000000000000000000000000000000000000000000000000000000#0
0#00000000000000000000000000000000000000000000000000000000#0
0#00000000000000000000000000000000000000000000000000000000#0
0#00000000000000000000000000000000000000000000000000000000#0
0#00000000000000000000000000000000000000000000000000000000#0
0##########################################################0
000000000000000000000000000000000000000000000000000000000000
000000000000000000000000000000000000000000000000000000000000
000000000000000000000000000000000000000000000000000000000000